"Ano","Unidade da Federação","Assistência Médica","Incapacidade Temporária","Incap Temporária menos 15 dias","Incap Temporária mais 15 dias","Incapacidade Permanente","Óbito","Acidentes Liquidados","Conseqüência"
"1995","Rondônia","8","381","171","210","91","0","480","Assistência Médica"
"1995","Acre","0","89","58","31","7","3","99","Assistência Médica"
"1995","Amazonas","393","1607","929","678","112","60","2172","Assistência Médica"
"1995","Roraima","0","0","0","0","0","0","0","Assistência Médica"
"1995","Pará","204","2067","1128","939","155","51","2477","Assistência Médica"
"1995","Amapá","2","161","101","60","0","7","170","Assistência Médica"
"1995","Tocantins","20","183","89","94","19","7","229","Assistência Médica"
"1995","Maranhão","2","23","5","18","65","5","95","Assistência Médica"
"1995","Piauí","1","342","51","291","22","30","395","Assistência Médica"
"1995","Ceará","219","3244","1031","2213","215","123","3801","Assistência Médica"
"1995","Rio Grande do Norte","108","917","344","573","69","24","1118","Assistência Médica"
"1995","Paraíba","22","683","372","311","85","30","820","Assistência Médica"
"1995","Pernambuco","81","6057","3197","2860","429","156","6723","Assistência Médica"
"1995","Alagoas","43","2840","2176","664","67","41","2991","Assistência Médica"
"1995","Sergipe","284","1146","315","831","107","38","1575","Assistência Médica"
"1995","Bahia","227","2470","1107","1363","698","110","3505","Assistência Médica"
"1995","Minas Gerais","8551","47428","31506","15922","1771","403","58153","Assistência Médica"
"1995","Espírito Santo","1714","4310","1716","2594","255","132","6411","Assistência Médica"
"1995","Rio de Janeiro","1349","12676","5904","6772","1015","441","15481","Assistência Médica"
"1995","São Paulo","34926","210193","143678","66515","7327","1578","254024","Assistência Médica"
"1995","Paraná","790","16131","10029","6102","620","362","17903","Assistência Médica"
"1995","Santa Catarina","1881","22433","14104","8329","694","156","25164","Assistência Médica"
"1995","Rio Grande do Sul","0","0","0","0","660","0","660","Assistência Médica"
"1995","Mato Grosso do Sul","243","1551","491","1060","150","52","1996","Assistência Médica"
"1995","Mato Grosso","282","231","186","45","159","0","672","Assistência Médica"
"1995","Goiás","475","3887","2482","1405","216","109","4687","Assistência Médica"
"1995","Distrito Federal","0","2048","1170","878","148","49","2245","Assistência Médica"
"1994","Rondônia","0","0","0","0","73","0","73","Assistência Médica"
"1994","Acre","0","0","0","0","7","0","7","Assistência Médica"
"1994","Amazonas","42","1077","453","624","26","39","1184","Assistência Médica"
"1994","Roraima","0","0","0","0","0","0","0","Assistência Médica"
"1994","Pará","312","1612","948","664","54","33","2011","Assistência Médica"
"1994","Amapá","0","0","0","0","0","0","0","Assistência Médica"
"1994","Tocantins","0","0","0","0","0","0","0","Assistência Médica"
"1994","Maranhão","0","29","0","29","44","1","74","Assistência Médica"
"1994","Piauí","2","486","66","420","15","25","528","Assistência Médica"
"1994","Ceará","34","968","455","513","64","18","1084","Assistência Médica"
"1994","Rio Grande do Norte","60","461","141","320","51","27","599","Assistência Médica"
"1994","Paraíba","30","646","421","225","28","21","725","Assistência Médica"
"1994","Pernambuco","401","3756","1623","2133","182","145","4484","Assistência Médica"
"1994","Alagoas","56","1131","559","572","7","47","1241","Assistência Médica"
"1994","Sergipe","236","717","270","447","24","28","1005","Assistência Médica"
"1994","Bahia","331","4077","786","3291","211","113","4732","Assistência Médica"
"1994","Minas Gerais","8227","34237","19929","14308","260","438","43162","Assistência Médica"
"1994","Espírito Santo","1362","3333","1308","2025","69","127","4891","Assistência Médica"
"1994","Rio de Janeiro","994","11400","6090","5310","366","176","12936","Assistência Médica"
"1994","São Paulo","25804","190899","129485","61414","3509","1175","221387","Assistência Médica"
"1994","Paraná","604","17903","10457","7446","182","255","18944","Assistência Médica"
"1994","Santa Catarina","1956","20059","12365","7694","236","164","22415","Assistência Médica"
"1994","Rio Grande do Sul","223","7867","1998","5869","314","99","8503","Assistência Médica"
"1994","Mato Grosso do Sul","143","1845","575","1270","58","72","2118","Assistência Médica"
"1994","Mato Grosso","243","319","72","247","53","18","633","Assistência Médica"
"1994","Goiás","180","4089","1939","2150","99","90","4458","Assistência Médica"
"1994","Distrito Federal","19","1028","585","443","30","18","1095","Assistência Médica"
"1993","Rondônia","0","218","0","218","54","0","272","Assistência Médica"
"1993","Acre","2","6","4","2","8","0","16","Assistência Médica"
"1993","Amazonas","9","2274","1059","1215","113","40","2436","Assistência Médica"
"1993","Pará","154","1081","765","316","291","13","1539","Assistência Médica"
"1993","Maranhão","0","168","0","168","93","29","290","Assistência Médica"
"1993","Piauí","38","386","50","336","67","26","517","Assistência Médica"
"1993","Ceará","108","2392","1066","1326","249","59","2808","Assistência Médica"
"1993","Rio Grande do Norte","102","930","160","770","132","32","1196","Assistência Médica"
"1993","Paraíba","6","185","57","128","124","7","322","Assistência Médica"
"1993","Pernambuco","22","732","625","107","794","0","1548","Assistência Médica"
"1993","Alagoas","47","1020","459","561","59","12","1138","Assistência Médica"
"1993","Sergipe","401","1188","826","362","81","19","1689","Assistência Médica"
"1993","Bahia","254","3978","809","3169","756","0","4988","Assistência Médica"
"1993","Minas Gerais","14516","36679","24898","11781","1499","393","53087","Assistência Médica"
"1993","Espírito Santo","1469","4099","1809","2290","232","108","5908","Assistência Médica"
"1993","Rio de Janeiro","317","5831","2378","3453","1349","95","7592","Assistência Médica"
"1993","São Paulo","27898","201711","140412","61299","7516","1357","238482","Assistência Médica"
"1993","Paraná","1253","24467","13690","10777","724","349","26793","Assistência Médica"
"1993","Santa Catarina","1613","22007","13260","8747","725","189","24534","Assistência Médica"
"1993","Rio Grande do Sul","1568","14761","8119","6642","1334","173","17836","Assistência Médica"
"1993","Mato Grosso do Sul","364","1622","601","1021","123","70","2179","Assistência Médica"
"1993","Mato Grosso","34","86","19","67","172","0","292","Assistência Médica"
"1993","Goiás","145","3725","1829","1896","229","84","4183","Assistência Médica"
"1993","Distrito Federal","9","2952","1787","1165","171","55","3187","Assistência Médica"
"1992","Rondônia","58","72","0","72","56","15","201","Assistência Médica"
"1992","Acre","25","45","0","45","14","8","92","Assistência Médica"
"1992","Amazonas","134","828","313","515","118","22","1102","Assistência Médica"
"1992","Pará","3405","1743","497","1246","230","42","5420","Assistência Médica"
"1992","Maranhão","56","289","253","36","209","46","600","Assistência Médica"
"1992","Piauí","19","629","112","517","50","18","716","Assistência Médica"
"1992","Ceará","209","2952","1480","1472","258","68","3487","Assistência Médica"
"1992","Rio Grande do Norte","397","315","44","271","162","24","898","Assistência Médica"
"1992","Paraíba","15","1039","808","231","93","49","1196","Assistência Médica"
"1992","Pernambuco","683","4507","1799","2708","594","153","5937","Assistência Médica"
"1992","Alagoas","114","1601","672","929","81","34","1830","Assistência Médica"
"1992","Sergipe","541","1706","1266","440","65","21","2333","Assistência Médica"
"1992","Bahia","646","7764","3263","4501","541","211","9162","Assistência Médica"
"1992","Minas Gerais","16949","41398","28191","13207","1262","330","59939","Assistência Médica"
"1992","Espírito Santo","1295","5233","1807","3426","160","129","6817","Assistência Médica"
"1992","Rio de Janeiro","1420","20060","6393","13667","2009","213","23702","Assistência Médica"
"1992","São Paulo","47390","234088","148668","85420","7157","1381","290016","Assistência Médica"
"1992","Paraná","4397","28276","19207","9069","825","311","33809","Assistência Médica"
"1992","Santa Catarina","4895","25505","14397","11108","823","91","31314","Assistência Médica"
"1992","Rio Grande do Sul","6745","36590","20490","16100","1416","160","44911","Assistência Médica"
"1992","Mato Grosso do Sul","493","1626","675","951","123","5","2247","Assistência Médica"
"1992","Mato Grosso","98","426","119","307","128","66","718","Assistência Médica"
"1992","Goiás","325","3980","2647","1333","229","56","4590","Assistência Médica"
"1992","Distrito Federal","293","3214","2176","1038","103","63","3673","Assistência Médica"
"1991","Rondônia","88","503","0","503","143","19","753","Assistência Médica"
"1991","Acre","54","54","0","54","9","9","126","Assistência Médica"
"1991","Amazonas","2025","1935","61","1874","109","44","4113","Assistência Médica"
"1991","Pará","2685","5199","2038","3161","292","58","8234","Assistência Médica"
"1991","Maranhão","55","2311","1949","362","172","32","2570","Assistência Médica"
"1991","Piauí","20","395","52","343","14","28","457","Assistência Médica"
"1991","Ceará","418","4348","1914","2434","239","86","5091","Assistência Médica"
"1991","Rio Grande do Norte","1138","2831","2096","735","175","48","4192","Assistência Médica"
"1991","Paraíba","11","1536","961","575","86","23","1656","Assistência Médica"
"1991","Pernambuco","820","7406","2252","5154","553","182","8961","Assistência Médica"
"1991","Alagoas","61","2045","814","1231","87","38","2231","Assistência Médica"
"1991","Sergipe","491","2456","1728","728","48","37","3032","Assistência Médica"
"1991","Bahia","757","9638","4187","5451","393","131","10919","Assistência Médica"
"1991","Minas Gerais","17292","44883","28735","16148","1485","308","63968","Assistência Médica"
"1991","Espírito Santo","1431","5207","1822","3385","158","102","6898","Assistência Médica"
"1991","Rio de Janeiro","2336","35333","15522","19811","4104","325","42098","Assistência Médica"
"1991","São Paulo","58043","272713","184124","88589","8851","1256","340863","Assistência Médica"
"1991","Paraná","10399","38885","26996","11889","622","324","50230","Assistência Médica"
"1991","Santa Catarina","5477","29103","17088","12015","700","182","35462","Assistência Médica"
"1991","Rio Grande do Sul","9218","53738","30622","23116","1065","908","64929","Assistência Médica"
"1991","Mato Grosso do Sul","394","2427","1020","1407","140","87","3048","Assistência Médica"
"1991","Mato Grosso","407","1677","985","692","133","111","2328","Assistência Médica"
"1991","Goiás","468","11933","7863","4070","306","111","12818","Assistência Médica"
"1991","Distrito Federal","64","2332","1278","1054","88","78","2562","Assistência Médica"
"1990","Rondônia","84","985","0","985","58","29","1156","Assistência Médica"
"1990","Acre","64","72","0","72","10","5","151","Assistência Médica"
"1990","Amazonas","2161","2433","155","2278","103","53","4750","Assistência Médica"
"1990","Pará","736","3670","2098","1572","211","17","4634","Assistência Médica"
"1990","Maranhão","3","4379","3820","559","192","43","4617","Assistência Médica"
"1990","Piauí","15","583","62","521","57","32","687","Assistência Médica"
"1990","Ceará","411","5207","2856","2351","283","121","6022","Assistência Médica"
"1990","Rio Grande do Norte","556","1175","55","1120","213","28","1972","Assistência Médica"
"1990","Paraíba","18","1976","1532","444","94","31","2119","Assistência Médica"
"1990","Pernambuco","114","10172","3913","6259","770","215","11271","Assistência Médica"
"1990","Alagoas","83","2739","1035","1704","70","64","2956","Assistência Médica"
"1990","Sergipe","363","2430","1626","804","65","47","2905","Assistência Médica"
"1990","Bahia","416","13583","6132","7451","608","220","14827","Assistência Médica"
"1990","Minas Gerais","9985","59338","39817","19521","1342","397","71062","Assistência Médica"
"1990","Espírito Santo","1179","6101","2286","3815","231","106","7617","Assistência Médica"
"1990","Rio de Janeiro","648","57422","24845","32577","4518","428","63016","Assistência Médica"
"1990","São Paulo","18266","310204","201627","108577","6866","1402","336738","Assistência Médica"
"1990","Paraná","8455","46476","33322","13154","715","414","56060","Assistência Médica"
"1990","Santa Catarina","3964","38471","23277","15194","856","322","43613","Assistência Médica"
"1990","Rio Grande do Sul","8466","74016","41793","32223","986","978","84446","Assistência Médica"
"1990","Mato Grosso do Sul","758","2599","963","1636","151","59","3567","Assistência Médica"
"1990","Mato Grosso","317","1391","772","619","95","107","1910","Assistência Médica"
"1990","Goiás","4004","11169","5717","5452","248","151","15572","Assistência Médica"
"1990","Distrito Federal","169","3516","1892","1624","136","86","3907","Assistência Médica"
"1989","Rondônia","97","450","0","450","71","27","645","Assistência Médica"
"1989","Acre","55","76","0","76","20","6","157","Assistência Médica"
"1989","Amazonas","2124","2412","241","2171","133","51","4720","Assistência Médica"
"1989","Pará","2284","7081","4173","2908","295","80","9740","Assistência Médica"
"1989","Maranhão","3","5359","4323","1036","191","76","5629","Assistência Médica"
"1989","Piauí","21","647","74","573","49","28","745","Assistência Médica"
"1989","Ceará","480","6205","3053","3152","305","102","7092","Assistência Médica"
"1989","Rio Grande do Norte","1291","1500","76","1424","168","37","2996","Assistência Médica"
"1989","Paraíba","23","1690","1228","462","108","24","1845","Assistência Médica"
"1989","Pernambuco","603","13771","5924","7847","642","224","15240","Assistência Médica"
"1989","Alagoas","38","2734","724","2010","125","42","2939","Assistência Médica"
"1989","Sergipe","369","3086","1551","1535","64","45","3564","Assistência Médica"
"1989","Bahia","620","9120","3833","5287","533","150","10423","Assistência Médica"
"1989","Minas Gerais","21769","73303","50211","23092","1335","415","96822","Assistência Médica"
"1989","Espírito Santo","2074","7421","3040","4381","263","105","9863","Assistência Médica"
"1989","Rio de Janeiro","4508","80769","37085","43684","4463","450","90190","Assistência Médica"
"1989","São Paulo","65370","346458","225676","120782","7310","1385","420523","Assistência Médica"
"1989","Paraná","6442","49351","35050","14301","770","375","56938","Assistência Médica"
"1989","Santa Catarina","6751","44854","28087","16767","757","202","52564","Assistência Médica"
"1989","Rio Grande do Sul","21138","89569","48055","41514","1333","338","112378","Assistência Médica"
"1989","Mato Grosso do Sul","713","3118","1250","1868","131","79","4041","Assistência Médica"
"1989","Mato Grosso","942","1868","954","914","161","104","3075","Assistência Médica"
"1989","Goiás","7393","8514","2732","5782","340","138","16385","Assistência Médica"
"1989","Distrito Federal","439","3854","2192","1662","254","71","4618","Assistência Médica"
"1988","Rondônia","78","286","0","286","72","45","481","Assistência Médica"
"1988","Acre","41","79","0","79","31","7","158","Assistência Médica"
"1988","Amazonas","2229","6273","2963","3310","129","48","8679","Assistência Médica"
"1988","Pará","1683","11430","7549","3881","290","104","13507","Assistência Médica"
"1988","Maranhão","4","5644","3897","1747","98","62","5808","Assistência Médica"
"1988","Piauí","54","749","179","570","42","31","876","Assistência Médica"
"1988","Ceará","269","6037","3143","2894","250","81","6637","Assistência Médica"
"1988","Rio Grande do Norte","1531","1576","117","1459","148","34","3289","Assistência Médica"
"1988","Paraíba","30","2607","1945","662","111","42","2790","Assistência Médica"
"1988","Pernambuco","799","13594","5848","7746","625","223","15241","Assistência Médica"
"1988","Alagoas","262","4119","821","3298","77","46","4504","Assistência Médica"
"1988","Sergipe","473","3620","1885","1735","52","47","4192","Assistência Médica"
"1988","Bahia","2934","17714","6726","10988","474","172","21294","Assistência Médica"
"1988","Minas Gerais","24212","72947","49001","23946","1425","358","98942","Assistência Médica"
"1988","Espírito Santo","2201","10606","5101","5505","269","96","13172","Assistência Médica"
"1988","Rio de Janeiro","5402","89782","39287","50495","4980","540","100704","Assistência Médica"
"1988","São Paulo","71927","382675","247891","134784","8234","1400","464236","Assistência Médica"
"1988","Paraná","9421","62364","43867","18497","826","392","73003","Assistência Médica"
"1988","Santa Catarina","5537","46659","29170","17489","625","261","53082","Assistência Médica"
"1988","Rio Grande do Sul","6801","81304","44697","36607","1201","243","89549","Assistência Médica"
"1988","Mato Grosso do Sul","740","3912","1876","2036","150","79","4881","Assistência Médica"
"1988","Mato Grosso","1147","1887","1130","757","111","84","3229","Assistência Médica"
"1988","Goiás","9544","9368","3320","6048","296","139","19347","Assistência Médica"
"1988","Distrito Federal","96","4138","2031","2107","259","82","4575","Assistência Médica"
"1996","Rondônia","13","748","305","443","61","31","853","Assistência Médica"
"1996","Acre","3","61","14","47","7","5","76","Assistência Médica"
"1996","Amazonas","4","938","0","938","185","8","1135","Assistência Médica"
"1996","Roraima","165","1786","946","840","96","1","2048","Assistência Médica"
"1996","Pará","716","2442","839","1603","176","70","3404","Assistência Médica"
"1996","Amapá","0","75","25","50","14","3","92","Assistência Médica"
"1996","Tocantins","1","213","44","169","11","26","251","Assistência Médica"
"1996","Maranhão","0","530","81","449","70","33","633","Assistência Médica"
"1996","Piauí","0","291","7","284","86","27","404","Assistência Médica"
"1996","Ceará","54","2581","891","1690","246","90","2971","Assistência Médica"
"1996","Rio Grande do Norte","132","1211","426","785","240","37","1620","Assistência Médica"
"1996","Paraíba","63","1042","479","563","147","33","1285","Assistência Médica"
"1996","Pernambuco","307","7986","3912","4074","464","186","8943","Assistência Médica"
"1996","Alagoas","113","2258","1561","697","70","56","2497","Assistência Médica"
"1996","Sergipe","157","1007","501","506","68","50","1282","Assistência Médica"
"1996","Bahia","2870","6280","1169","5111","706","232","10088","Assistência Médica"
"1996","Minas Gerais","6352","43451","25499","17952","3844","530","54177","Assistência Médica"
"1996","Espírito Santo","903","4791","1991","2800","327","121","6142","Assistência Médica"
"1996","Rio de Janeiro","2721","22927","9718","13209","771","358","26777","Assistência Médica"
"1996","São Paulo","24708","168506","112632","55874","6123","1439","200776","Assistência Médica"
"1996","Paraná","3787","22113","12983","9130","698","309","26907","Assistência Médica"
"1996","Santa Catarina","4019","36754","22930","13824","1729","228","42730","Assistência Médica"
"1996","Rio Grande do Sul","3132","36357","17293","19064","1078","270","40837","Assistência Médica"
"1996","Mato Grosso do Sul","36","2643","835","1808","494","77","3250","Assistência Médica"
"1996","Mato Grosso","114","2122","781","1341","144","114","2494","Assistência Médica"
"1996","Goiás","272","4291","2005","2286","192","103","4858","Assistência Médica"
"1996","Distrito Federal","40","2091","459","1632","186","51","2368","Assistência Médica"
"1997","Rondônia","16","939","371","568","71","34","1060","Assistência Médica"
"1997","Acre","2","74","9","65","7","4","87","Assistência Médica"
"1997","Amazonas","0","936","2","934","108","18","1062","Assistência Médica"
"1997","Roraima","0","35","0","35","15","5","55","Assistência Médica"
"1997","Pará","583","2229","698","1531","258","57","3127","Assistência Médica"
"1997","Amapá","0","164","95","69","5","6","175","Assistência Médica"
"1997","Tocantins","0","246","59","187","28","9","283","Assistência Médica"
"1997","Maranhão","9","527","32","495","42","22","600","Assistência Médica"
"1997","Piauí","1","316","25","291","18","22","357","Assistência Médica"
"1997","Ceará","159","2494","829","1665","271","77","3001","Assistência Médica"
"1997","Rio Grande do Norte","76","1172","376","796","119","34","1401","Assistência Médica"
"1997","Paraíba","130","1163","504","659","120","37","1450","Assistência Médica"
"1997","Pernambuco","348","7761","3701","4060","509","125","8743","Assistência Médica"
"1997","Alagoas","204","2505","1734","771","68","33","2810","Assistência Médica"
"1997","Sergipe","296","940","471","469","62","57","1355","Assistência Médica"
"1997","Bahia","1968","7625","2224","5401","959","137","10689","Assistência Médica"
"1997","Minas Gerais","8565","41507","23677","17830","4417","397","54886","Assistência Médica"
"1997","Espírito Santo","835","4616","1944","2672","509","121","6081","Assistência Médica"
"1997","Rio de Janeiro","3380","20198","8781","11417","861","253","24692","Assistência Médica"
"1997","São Paulo","28086","178864","119555","59309","5999","1019","213968","Assistência Médica"
"1997","Paraná","5785","20882","11035","9847","763","268","27698","Assistência Médica"
"1997","Santa Catarina","2466","20377","10557","9820","524","210","23577","Assistência Médica"
"1997","Rio Grande do Sul","2911","34717","15115","19602","969","215","38812","Assistência Médica"
"1997","Mato Grosso do Sul","52","2914","1096","1818","179","66","3211","Assistência Médica"
"1997","Mato Grosso","177","2684","1124","1560","170","116","3147","Assistência Médica"
"1997","Goiás","277","4867","2142","2725","337","85","5566","Assistência Médica"
"1997","Distrito Federal","105","1960","452","1508","281","42","2388","Assistência Médica"
"1998","Rondônia","15","1160","377","783","84","48","1307","Assistência Médica"
"1998","Acre","3","72","3","69","7","3","85","Assistência Médica"
"1998","Amazonas","20","1009","15","994","46","28","1103","Assistência Médica"
"1998","Roraima","1","45","0","45","9","6","61","Assistência Médica"
"1998","Pará","712","2232","646","1586","263","71","3278","Assistência Médica"
"1998","Amapá","0","112","46","66","10","10","132","Assistência Médica"
"1998","Tocantins","4","365","124","241","18","31","418","Assistência Médica"
"1998","Maranhão","6","513","45","468","56","36","611","Assistência Médica"
"1998","Piauí","0","313","35","278","31","33","377","Assistência Médica"
"1998","Ceará","180","2559","882","1677","281","80","3100","Assistência Médica"
"1998","Rio Grande do Norte","85","1435","646","789","148","42","1710","Assistência Médica"
"1998","Paraíba","54","1023","364","659","136","37","1250","Assistência Médica"
"1998","Pernambuco","345","5819","2565","3254","501","133","6798","Assistência Médica"
"1998","Alagoas","346","2473","1768","705","59","42","2920","Assistência Médica"
"1998","Sergipe","413","941","480","461","67","31","1452","Assistência Médica"
"1998","Bahia","1826","6023","1590","4433","863","151","8863","Assistência Médica"
"1998","Minas Gerais","8877","36707","21691","15016","3646","413","49643","Assistência Médica"
"1998","Espírito Santo","972","4378","1805","2573","338","108","5796","Assistência Médica"
"1998","Rio de Janeiro","3498","18627","8166","10461","765","343","23233","Assistência Médica"
"1998","São Paulo","24778","161248","107980","53268","5084","989","192099","Assistência Médica"
"1998","Paraná","7555","21468","11461","10007","787","330","30140","Assistência Médica"
"1998","Santa Catarina","2742","20791","11212","9579","510","205","24248","Assistência Médica"
"1998","Rio Grande do Sul","2570","31381","11772","19609","1212","222","35385","Assistência Médica"
"1998","Mato Grosso do Sul","48","2783","884","1899","186","76","3093","Assistência Médica"
"1998","Mato Grosso","257","2919","988","1931","171","132","3479","Assistência Médica"
"1998","Goiás","287","5067","2237","2830","396","127","5877","Assistência Médica"
"1998","Distrito Federal","92","1771","439","1332","249","66","2178","Assistência Médica"
"1998","Ignorado","0","0","0","0","0","0","0","Assistência Médica"
"1999","Rondônia","28","1299","466","833","120","39","1486","Assistência Médica"
"1999","Acre","0","74","13","61","21","6","101","Assistência Médica"
"1999","Amazonas","222","1216","391","825","65","22","1525","Assistência Médica"
"1999","Roraima","1","50","4","46","14","7","72","Assistência Médica"
"1999","Pará","862","2497","717","1780","227","115","3701","Assistência Médica"
"1999","Amapá","5","130","33","97","3","7","145","Assistência Médica"
"1999","Tocantins","106","416","171","245","27","15","564","Assistência Médica"
"1999","Maranhão","16","420","52","368","130","26","592","Assistência Médica"
"1999","Piauí","21","294","34","260","67","25","407","Assistência Médica"
"1999","Ceará","641","2526","904","1622","225","77","3469","Assistência Médica"
"1999","Rio Grande do Norte","71","1319","541","778","206","20","1616","Assistência Médica"
"1999","Paraíba","39","948","348","600","140","37","1164","Assistência Médica"
"1999","Pernambuco","369","5462","2375","3087","489","141","6461","Assistência Médica"
"1999","Alagoas","314","2542","1928","614","88","35","2979","Assistência Médica"
"1999","Sergipe","287","945","509","436","97","18","1347","Assistência Médica"
"1999","Bahia","1582","5499","1814","3685","1178","140","8399","Assistência Médica"
"1999","Minas Gerais","11550","39037","25643","13394","3008","458","54053","Assistência Médica"
"1999","Espírito Santo","1120","4365","1901","2464","309","121","5915","Assistência Médica"
"1999","Rio de Janeiro","3835","17866","8272","9594","1247","362","23310","Assistência Médica"
"1999","São Paulo","25727","164390","112784","51606","5603","1054","196774","Assistência Médica"
"1999","Paraná","2957","26884","17048","9836","699","318","30858","Assistência Médica"
"1999","Santa Catarina","1563","21901","11729","10172","594","210","24268","Assistência Médica"
"1999","Rio Grande do Sul","2872","31760","12505","19255","1223","229","36084","Assistência Médica"
"1999","Mato Grosso do Sul","81","3046","883","2163","253","67","3447","Assistência Médica"
"1999","Mato Grosso","263","2957","945","2012","162","138","3520","Assistência Médica"
"1999","Goiás","262","5501","2364","3137","416","151","6330","Assistência Médica"
"1999","Distrito Federal","111","1690","458","1232","146","58","2005","Assistência Médica"
"2000","Rondônia","130","1780","773","1007","102","79","2091","Assistência Médica"
"2000","Acre","19","176","85","91","16","4","215","Assistência Médica"
"2000","Amazonas","328","2160","1265","895","40","25","2553","Assistência Médica"
"2000","Roraima","2","83","25","58","13","3","101","Assistência Médica"
"2000","Pará","569","3464","1460","2004","271","91","4395","Assistência Médica"
"2000","Amapá","19","194","106","88","5","5","223","Assistência Médica"
"2000","Tocantins","77","609","317","292","38","27","751","Assistência Médica"
"2000","Maranhão","144","796","363","433","107","27","1074","Assistência Médica"
"2000","Piauí","61","475","203","272","72","17","625","Assistência Médica"
"2000","Ceará","605","2873","1118","1755","187","38","3703","Assistência Médica"
"2000","Rio Grande do Norte","171","1335","562","773","162","31","1699","Assistência Médica"
"2000","Paraíba","250","1279","621","658","147","22","1698","Assistência Médica"
"2000","Pernambuco","437","5297","2362","2935","370","126","6230","Assistência Médica"
"2000","Alagoas","276","2930","1974","956","56","30","3292","Assistência Médica"
"2000","Sergipe","255","933","497","436","65","24","1277","Assistência Médica"
"2000","Bahia","2150","6460","2236","4224","865","126","9601","Assistência Médica"
"2000","Minas Gerais","7794","35534","21382","14152","2669","373","46370","Assistência Médica"
"2000","Espírito Santo","1292","5239","2463","2776","311","139","6981","Assistência Médica"
"2000","Rio de Janeiro","3359","18466","8977","9489","788","246","22859","Assistência Médica"
"2000","São Paulo","21598","130645","77967","52678","5799","722","158764","Assistência Médica"
"2000","Paraná","4065","21809","11637","10172","684","239","26797","Assistência Médica"
"2000","Santa Catarina","2738","23714","12278","11436","565","170","27187","Assistência Médica"
"2000","Rio Grande do Sul","3836","35114","15435","19679","1023","186","40159","Assistência Médica"
"2000","Mato Grosso do Sul","311","3889","1589","2300","189","74","4463","Assistência Médica"
"2000","Mato Grosso","218","3933","1629","2304","254","96","4501","Assistência Médica"
"2000","Goiás","553","6513","3148","3365","328","126","7520","Assistência Médica"
"2000","Distrito Federal","217","2998","1605","1393","191","48","3454","Assistência Médica"
"2001","Rondônia","108","1766","808","958","95","29","1998","Assistência Médica"
"2001","Acre","31","199","102","97","6","10","246","Assistência Médica"
"2001","Amazonas","365","2260","1403","857","60","23","2708","Assistência Médica"
"2001","Roraima","3","93","27","66","7","2","105","Assistência Médica"
"2001","Pará","1045","4043","1965","2078","273","98","5459","Assistência Médica"
"2001","Amapá","40","277","160","117","3","3","323","Assistência Médica"
"2001","Tocantins","269","659","330","329","39","33","1000","Assistência Médica"
"2001","Maranhão","234","880","424","456","60","25","1199","Assistência Médica"
"2001","Piauí","59","448","192","256","46","25","578","Assistência Médica"
"2001","Ceará","429","2978","1189","1789","203","42","3652","Assistência Médica"
"2001","Rio Grande do Norte","297","1573","740","833","153","26","2049","Assistência Médica"
"2001","Paraíba","342","1318","682","636","130","15","1805","Assistência Médica"
"2001","Pernambuco","631","5470","2299","3171","359","77","6537","Assistência Médica"
"2001","Alagoas","242","2351","1499","852","47","32","2672","Assistência Médica"
"2001","Sergipe","324","847","419","428","68","31","1270","Assistência Médica"
"2001","Bahia","2510","6473","2380","4093","476","127","9586","Assistência Médica"
"2001","Minas Gerais","7325","30634","17260","13374","1880","307","40146","Assistência Médica"
"2001","Espírito Santo","1610","5940","2978","2962","308","109","7967","Assistência Médica"
"2001","Rio de Janeiro","3036","16216","7401","8815","767","189","20208","Assistência Médica"
"2001","São Paulo","21266","116125","65109","51016","4206","750","142347","Assistência Médica"
"2001","Paraná","2972","20476","10151","10325","684","211","24343","Assistência Médica"
"2001","Santa Catarina","3178","23722","12260","11462","423","143","27466","Assistência Médica"
"2001","Rio Grande do Sul","3416","32399","13331","19068","871","163","36849","Assistência Médica"
"2001","Mato Grosso do Sul","423","3596","1252","2344","202","57","4278","Assistência Médica"
"2001","Mato Grosso","160","4186","1563","2623","188","103","4637","Assistência Médica"
"2001","Goiás","1109","6669","3214","3455","311","96","8185","Assistência Médica"
"2001","Distrito Federal","262","3393","1910","1483","173","27","3855","Assistência Médica"
"2002","Rondônia","131","1914","735","1179","184","34","2263","Assistência Médica"
"2002","Acre","30","288","148","140","22","4","344","Assistência Médica"
"2002","Amazonas","347","2837","1698","1139","64","36","3284","Assistência Médica"
"2002","Roraima","2","115","35","80","5","7","129","Assistência Médica"
"2002","Pará","1479","5038","2410","2628","364","95","6976","Assistência Médica"
"2002","Amapá","41","255","137","118","11","3","310","Assistência Médica"
"2002","Tocantins","130","656","291","365","37","15","838","Assistência Médica"
"2002","Maranhão","355","1062","485","577","80","33","1530","Assistência Médica"
"2002","Piauí","40","582","263","319","70","17","709","Assistência Médica"
"2002","Ceará","365","3453","1427","2026","287","29","4134","Assistência Médica"
"2002","Rio Grande do Norte","533","1754","903","851","120","28","2435","Assistência Médica"
"2002","Paraíba","290","1534","810","724","160","21","2005","Assistência Médica"
"2002","Pernambuco","596","6717","3168","3549","503","79","7895","Assistência Médica"
"2002","Alagoas","227","2813","1722","1091","94","40","3174","Assistência Médica"
"2002","Sergipe","416","1255","682","573","97","18","1786","Assistência Médica"
"2002","Bahia","3883","8574","3751","4823","673","153","13283","Assistência Médica"
"2002","Minas Gerais","7850","32093","17030","15063","1942","311","42196","Assistência Médica"
"2002","Espírito Santo","1983","6716","3493","3223","418","112","9229","Assistência Médica"
"2002","Rio de Janeiro","4960","21578","11570","10008","991","240","27769","Assistência Médica"
"2002","São Paulo","24341","135258","78254","57004","4805","815","165219","Assistência Médica"
"2002","Paraná","3994","24042","12473","11569","993","232","29261","Assistência Médica"
"2002","Santa Catarina","3122","25640","11892","13748","696","150","29608","Assistência Médica"
"2002","Rio Grande do Sul","4551","36137","16016","20121","1490","151","42329","Assistência Médica"
"2002","Mato Grosso do Sul","575","4294","1677","2617","222","65","5156","Assistência Médica"
"2002","Mato Grosso","333","4714","1916","2798","197","134","5378","Assistência Médica"
"2002","Goiás","1142","7777","3971","3806","423","110","9452","Assistência Médica"
"2002","Distrito Federal","437","4124","2255","1869","311","36","4908","Assistência Médica"
"2003","Rondônia","99","2056","785","1271","125","45","2325","Assistência Médica"
"2003","Acre","28","286","151","135","14","5","333","Assistência Médica"
"2003","Amazonas","422","3241","2126","1115","42","24","3729","Assistência Médica"
"2003","Roraima","1","120","64","56","12","4","137","Assistência Médica"
"2003","Pará","1113","5774","2944","2830","364","114","7365","Assistência Médica"
"2003","Amapá","23","215","103","112","12","4","254","Assistência Médica"
"2003","Tocantins","85","842","446","396","32","22","981","Assistência Médica"
"2003","Maranhão","323","1518","904","614","103","29","1973","Assistência Médica"
"2003","Piauí","40","729","375","354","63","25","857","Assistência Médica"
"2003","Ceará","419","3850","1810","2040","234","46","4549","Assistência Médica"
"2003","Rio Grande do Norte","453","2202","1299","903","91","32","2778","Assistência Médica"
"2003","Paraíba","273","1678","944","734","121","19","2091","Assistência Médica"
"2003","Pernambuco","801","6984","3359","3625","390","89","8264","Assistência Médica"
"2003","Alagoas","302","3218","2055","1163","56","40","3616","Assistência Médica"
"2003","Sergipe","377","1182","694","488","70","9","1638","Assistência Médica"
"2003","Bahia","3972","9685","4735","4950","612","116","14385","Assistência Médica"
"2003","Minas Gerais","7658","34763","20424","14339","1589","295","44305","Assistência Médica"
"2003","Espírito Santo","1845","6883","3844","3039","325","93","9146","Assistência Médica"
"2003","Rio de Janeiro","5335","21925","12870","9055","627","164","28051","Assistência Médica"
"2003","São Paulo","22816","133457","80719","52738","4737","665","161675","Assistência Médica"
"2003","Paraná","3980","25855","13403","12452","846","225","30906","Assistência Médica"
"2003","Santa Catarina","2699","24719","10612","14107","774","145","28337","Assistência Médica"
"2003","Rio Grande do Sul","5566","35785","17575","18210","1243","126","42720","Assistência Médica"
"2003","Mato Grosso do Sul","504","4783","2141","2642","179","53","5519","Assistência Médica"
"2003","Mato Grosso","454","5444","2473","2971","207","141","6246","Assistência Médica"
"2003","Goiás","1302","9039","5193","3846","375","103","10819","Assistência Médica"
"2003","Distrito Federal","461","4070","2367","1703","173","41","4745","Assistência Médica"
"2004","Rondônia","119","2374","1081","1293","146","44","2683","Assistência Médica"
"2004","Acre","26","353","191","162","21","8","408","Assistência Médica"
"2004","Amazonas","476","4037","2716","1321","42","36","4591","Assistência Médica"
"2004","Roraima","3","124","70","54","16","2","145","Assistência Médica"
"2004","Pará","1460","7378","4118","3260","340","93","9271","Assistência Médica"
"2004","Amapá","56","280","157","123","15","4","355","Assistência Médica"
"2004","Tocantins","801","1139","625","514","49","22","2011","Assistência Médica"
"2004","Maranhão","388","1746","1072","674","110","38","2282","Assistência Médica"
"2004","Piauí","38","921","619","302","66","24","1049","Assistência Médica"
"2004","Ceará","617","5197","2966","2231","176","43","6033","Assistência Médica"
"2004","Rio Grande do Norte","819","2884","1909","975","125","23","3851","Assistência Médica"
"2004","Paraíba","348","1821","1103","718","101","12","2282","Assistência Médica"
"2004","Pernambuco","977","8501","4699","3802","325","110","9913","Assistência Médica"
"2004","Alagoas","287","4446","3166","1280","57","36","4826","Assistência Médica"
"2004","Sergipe","494","1461","850","611","38","23","2016","Assistência Médica"
"2004","Bahia","3893","12768","6892","5876","768","101","17530","Assistência Médica"
"2004","Minas Gerais","9483","40948","26259","14689","1383","358","52172","Assistência Médica"
"2004","Espírito Santo","2043","8073","4906","3167","337","98","10551","Assistência Médica"
"2004","Rio de Janeiro","6191","27753","16704","11049","711","188","34843","Assistência Médica"
"2004","São Paulo","25112","157023","99103","57920","4460","677","187272","Assistência Médica"
"2004","Paraná","4744","30086","16711","13375","989","215","36034","Assistência Médica"
"2004","Santa Catarina","2554","29591","14924","14667","794","146","33085","Assistência Médica"
"2004","Rio Grande do Sul","6542","40230","21635","18595","1032","153","47957","Assistência Médica"
"2004","Mato Grosso do Sul","626","5852","2947","2905","209","61","6748","Assistência Médica"
"2004","Mato Grosso","459","6854","3408","3446","172","147","7632","Assistência Médica"
"2004","Goiás","1443","10395","6444","3951","259","139","12236","Assistência Médica"
"2004","Distrito Federal","413","5521","3573","1948","172","38","6144","Assistência Médica"
"2005","Alagoas","375","4460","3456","1004","90","38","4963","Assistência Médica"
"2005","Amazonas","772","4789","3402","1387","70","33","5664","Assistência Médica"
"2005","Bahia","3430","14693","8262","6431","940","164","19227","Assistência Médica"
"2005","Ceará","681","5573","3243","2330","164","42","6460","Assistência Médica"
"2005","Mato Grosso do Sul","720","6091","3356","2735","207","51","7069","Assistência Médica"
"2005","Espírito Santo","2387","9274","5803","3471","326","96","12083","Assistência Médica"
"2005","Goiás","1778","10998","6727","4271","371","121","13268","Assistência Médica"
"2005","Maranhão","499","2707","1953","754","130","32","3368","Assistência Médica"
"2005","Mato Grosso","488","7234","3707","3527","216","146","8084","Assistência Médica"
"2005","Minas Gerais","12117","42651","28625","14026","1308","352","56428","Assistência Médica"
"2005","Pará","1681","7433","4211","3222","373","85","9572","Assistência Médica"
"2005","Paraíba","585","2080","1389","691","109","19","2793","Assistência Médica"
"2005","Paraná","6084","32393","19219","13174","1180","206","39863","Assistência Médica"
"2005","Pernambuco","1444","9210","5342","3868","323","84","11061","Assistência Médica"
"2005","Piauí","100","996","637","359","72","22","1190","Assistência Médica"
"2005","Rio de Janeiro","7600","29572","19337","10235","828","168","38168","Assistência Médica"
"2005","Rio Grande do Norte","932","3262","2374","888","151","20","4365","Assistência Médica"
"2005","Rio Grande do Sul","7100","40323","22946","17377","996","128","48547","Assistência Médica"
"2005","Santa Catarina","3006","32334","18833","13501","799","153","36292","Assistência Médica"
"2005","São Paulo","29239","167233","112305","54928","5183","680","202335","Assistência Médica"
"2005","Sergipe","559","1739","1112","627","87","20","2405","Assistência Médica"
"2005","Distrito Federal","553","5896","3913","1983","218","23","6690","Assistência Médica"
"2005","Acre","39","423","192","231","25","10","497","Assistência Médica"
"2005","Amapá","49","356","187","169","10","10","425","Assistência Médica"
"2005","Rondônia","148","2533","1220","1313","136","37","2854","Assistência Médica"
"2005","Roraima","5","110","70","40","11","1","127","Assistência Médica"
"2005","Tocantins","786","1046","536","510","48","25","1905","Assistência Médica"
"2006","Alagoas","524","5877","5047","830","37","36","6474","Assistência Médica"
"2006","Amazonas","924","5848","4260","1588","60","27","6859","Assistência Médica"
"2006","Bahia","3696","15154","9594","5560","738","128","19716","Assistência Médica"
"2006","Ceará","695","5687","3661","2026","146","47","6575","Assistência Médica"
"2006","Mato Grosso do Sul","859","6259","3757","2502","106","58","7282","Assistência Médica"
"2006","Espírito Santo","2728","10250","7023","3227","233","94","13305","Assistência Médica"
"2006","Goiás","1711","12121","8009","4112","190","116","14138","Assistência Médica"
"2006","Maranhão","500","2369","1613","756","90","37","2996","Assistência Médica"
"2006","Mato Grosso","683","7547","4415","3132","121","154","8505","Assistência Médica"
"2006","Minas Gerais","11167","43790","31422","12368","812","365","56134","Assistência Médica"
"2006","Pará","2103","7601","4521","3080","235","106","10045","Assistência Médica"
"2006","Paraíba","593","2218","1561","657","129","17","2957","Assistência Médica"
"2006","Paraná","6247","33830","22182","11648","856","248","41181","Assistência Médica"
"2006","Pernambuco","1527","10389","7274","3115","362","71","12349","Assistência Médica"
"2006","Piauí","100","1088","727","361","51","15","1254","Assistência Médica"
"2006","Rio de Janeiro","7774","31402","21690","9712","434","202","39812","Assistência Médica"
"2006","Rio Grande do Norte","1581","3574","2572","1002","95","29","5279","Assistência Médica"
"2006","Rio Grande do Sul","7960","39979","23855","16124","616","125","48680","Assistência Médica"
"2006","Santa Catarina","3230","30381","17702","12679","459","153","34223","Assistência Médica"
"2006","São Paulo","31229","171973","120592","51381","3037","668","206907","Assistência Médica"
"2006","Sergipe","559","1893","1303","590","47","14","2513","Assistência Médica"
"2006","Distrito Federal","523","5841","4403","1438","175","30","6569","Assistência Médica"
"2006","Acre","48","426","241","185","20","5","499","Assistência Médica"
"2006","Amapá","102","412","249","163","15","3","532","Assistência Médica"
"2006","Rondônia","129","2486","1297","1189","102","26","2743","Assistência Médica"
"2006","Roraima","4","143","89","54","3","3","153","Assistência Médica"
"2006","Tocantins","287","1087","622","465","34","21","1429","Assistência Médica"
"2007","Alagoas","632","7067","5421","1646","103","30","7832","Assistência Médica"
"2007","Amazonas","1203","7559","4830","2729","48","24","8834","Assistência Médica"
"2007","Bahia","4126","20090","8507","11583","643","115","24974","Assistência Médica"
"2007","Ceará","807","7574","3732","3842","180","40","8601","Assistência Médica"
"2007","Mato Grosso do Sul","1452","8295","3987","4308","158","64","9969","Assistência Médica"
"2007","Espírito Santo","2647","13396","6858","6538","230","102","16375","Assistência Médica"
"2007","Goiás","1762","14537","8552","5985","239","107","16645","Assistência Médica"
"2007","Maranhão","701","3284","1561","1723","106","44","4135","Assistência Médica"
"2007","Mato Grosso","1016","10782","5214","5568","161","144","12103","Assistência Médica"
"2007","Minas Gerais","12340","56856","32175","24681","871","348","70415","Assistência Médica"
"2007","Pará","2499","9273","5320","3953","157","87","12016","Assistência Médica"
"2007","Paraíba","766","3139","1675","1464","109","34","4048","Assistência Médica"
"2007","Paraná","6811","45209","23979","21230","765","212","52997","Assistência Médica"
"2007","Pernambuco","1636","13084","7516","5568","257","81","15058","Assistência Médica"
"2007","Piauí","131","1585","640","945","38","18","1772","Assistência Médica"
"2007","Rio de Janeiro","8404","40607","20184","20423","459","181","49651","Assistência Médica"
"2007","Rio Grande do Norte","2270","4234","2315","1919","90","16","6610","Assistência Médica"
"2007","Rio Grande do Sul","7803","46176","21013","25163","630","151","54760","Assistência Médica"
"2007","Santa Catarina","3773","38754","15325","23429","627","139","43293","Assistência Médica"
"2007","São Paulo","34267","204588","116113","88475","3177","782","242814","Assistência Médica"
"2007","Sergipe","731","2192","1222","970","39","17","2979","Assistência Médica"
"2007","Distrito Federal","610","7176","3795","3381","101","43","7930","Assistência Médica"
"2007","Acre","45","597","250","347","16","9","667","Assistência Médica"
"2007","Amapá","167","585","373","212","12","6","770","Assistência Médica"
"2007","Rondônia","172","3778","1296","2482","131","29","4110","Assistência Médica"
"2007","Roraima","36","391","122","269","8","5","440","Assistência Médica"
"2007","Tocantins","494","1629","710","919","34","17","2174","Assistência Médica"
"2008","Rondônia","280","4416","1620","2796","220","34","4950","Assistência Médica"
"2008","Acre","58","751","233","518","55","7","871","Assistência Médica"
"2008","Amazonas","1377","8239","5096","3143","89","42","9747","Assistência Médica"
"2008","Roraima","12","513","134","379","15","3","543","Assistência Médica"
"2008","Pará","2385","9599","5193","4406","252","92","12328","Assistência Médica"
"2008","Amapá","113","529","279","250","12","4","658","Assistência Médica"
"2008","Tocantins","250","1896","779","1117","48","25","2219","Assistência Médica"
"2008","Maranhão","1025","4725","1950","2775","160","38","5948","Assistência Médica"
"2008","Piauí","140","2422","693","1729","91","19","2672","Assistência Médica"
"2008","Ceará","775","9325","3725","5600","253","54","10407","Assistência Médica"
"2008","Rio Grande do Norte","3005","5475","2650","2825","97","28","8605","Assistência Médica"
"2008","Paraíba","666","3600","1482","2118","138","21","4425","Assistência Médica"
"2008","Pernambuco","1738","15200","7668","7532","338","68","17344","Assistência Médica"
"2008","Alagoas","590","8025","5473","2552","91","31","8737","Assistência Médica"
"2008","Sergipe","559","2531","1295","1236","98","19","3207","Assistência Médica"
"2008","Bahia","4273","21926","8542","13384","983","120","27302","Assistência Médica"
"2008","Minas Gerais","13186","64988","32963","32025","1249","350","79773","Assistência Médica"
"2008","Espírito Santo","2789","14577","7242","7335","358","110","17834","Assistência Médica"
"2008","Rio de Janeiro","9620","44299","20412","23887","746","169","54834","Assistência Médica"
"2008","São Paulo","36712","230863","124834","106029","3955","741","272271","Assistência Médica"
"2008","Paraná","7390","50200","24228","25972","1011","205","58806","Assistência Médica"
"2008","Santa Catarina","4377","46844","15115","31729","985","154","52360","Assistência Médica"
"2008","Rio Grande do Sul","8449","55230","23095","32135","985","143","64807","Assistência Médica"
"2008","Mato Grosso do Sul","1694","9750","4216","5534","211","61","11716","Assistência Médica"
"2008","Mato Grosso","1368","12577","5673","6904","177","130","14252","Assistência Médica"
"2008","Goiás","1822","16057","8766","7291","326","102","18307","Assistência Médica"
"2008","Distrito Federal","596","8754","4346","4408","153","47","9550","Assistência Médica"
"2009","Alagoas","594","8486","5173","3313","238","29","9347","Assistência Médica"
"2009","Amazonas","1405","7511","4437","3074","98","27","9041","Assistência Médica"
"2009","Bahia","4117","22284","8204","14080","1088","121","27610","Assistência Médica"
"2009","Ceará","938","10948","4563","6385","311","48","12245","Assistência Médica"
"2009","Mato Grosso do Sul","1200","9577","3901","5676","250","44","11071","Assistência Médica"
"2009","Espírito Santo","2525","12615","6866","5749","273","84","15497","Assistência Médica"
"2009","Goiás","1668","15489","8294","7195","330","99","17586","Assistência Médica"
"2009","Maranhão","904","4984","2086","2898","210","44","6142","Assistência Médica"
"2009","Mato Grosso","1830","12347","5089","7258","239","128","14544","Assistência Médica"
"2009","Minas Gerais","12234","65424","31907","33517","1412","307","79377","Assistência Médica"
"2009","Pará","2325","9948","5356","4592","388","74","12735","Assistência Médica"
"2009","Paraíba","611","4251","1640","2611","150","24","5036","Assistência Médica"
"2009","Paraná","7817","46445","24078","22367","1004","220","55486","Assistência Médica"
"2009","Pernambuco","2021","16740","8129","8611","303","94","19158","Assistência Médica"
"2009","Piauí","157","2918","670","2248","117","19","3211","Assistência Médica"
"2009","Rio de Janeiro","9415","41220","20477","20743","946","158","51739","Assistência Médica"
"2009","Rio Grande do Norte","3126","5787","2830","2957","134","21","9068","Assistência Médica"
"2009","Rio Grande do Sul","7814","54253","21187","33066","1109","133","63309","Assistência Médica"
"2009","Santa Catarina","4526","45569","14837","30732","1282","114","51491","Assistência Médica"
"2009","São Paulo","35897","214765","118211","96554","4013","668","255343","Assistência Médica"
"2009","Sergipe","482","2653","1402","1251","118","19","3272","Assistência Médica"
"2009","Distrito Federal","736","8601","4399","4202","144","21","9502","Assistência Médica"
"2009","Acre","44","1023","360","663","50","5","1122","Assistência Médica"
"2009","Amapá","119","623","347","276","13","3","758","Assistência Médica"
"2009","Rondônia","351","4665","1556","3109","301","38","5355","Assistência Médica"
"2009","Roraima","13","522","126","396","21","3","559","Assistência Médica"
"2009","Tocantins","160","2279","775","1504","63","15","2517","Assistência Médica"
"2010","Alagoas","504","8806","5077","3729","289","30","9629","Assistência Médica"
"2010","Amazonas","1034","7600","4491","3109","111","33","8778","Assistência Médica"
"2010","Bahia","3590","20780","7399","13381","1335","122","25827","Assistência Médica"
"2010","Ceará","1014","11191","5028","6163","347","68","12620","Assistência Médica"
"2010","Mato Grosso do Sul","1186","8957","3645","5312","251","44","10438","Assistência Médica"
"2010","Espírito Santo","2568","11162","6511","4651","277","89","14096","Assistência Médica"
"2010","Goiás","1626","14134","7432","6702","297","133","16190","Assistência Médica"
"2010","Maranhão","727","5375","2059","3316","279","49","6430","Assistência Médica"
"2010","Mato Grosso","1726","11782","4953","6829","262","105","13875","Assistência Médica"
"2010","Minas Gerais","12013","63207","30916","32291","1613","346","77179","Assistência Médica"
"2010","Pará","2258","9371","4954","4417","337","75","12041","Assistência Médica"
"2010","Paraíba","412","4584","1694","2890","204","24","5224","Assistência Médica"
"2010","Paraná","7817","44281","23700","20581","1213","199","53510","Assistência Médica"
"2010","Pernambuco","2379","18032","8455","9577","311","99","20821","Assistência Médica"
"2010","Piauí","214","3067","746","2321","138","25","3444","Assistência Médica"
"2010","Rio de Janeiro","9118","39622","19876","19746","893","152","49785","Assistência Médica"
"2010","Rio Grande do Norte","1426","5757","2784","2973","211","16","7410","Assistência Médica"
"2010","Rio Grande do Sul","7369","51383","20696","30687","1287","153","60192","Assistência Médica"
"2010","Santa Catarina","4172","43445","15658","27787","1593","153","49363","Assistência Médica"
"2010","São Paulo","34045","211856","118189","93667","4045","719","250665","Assistência Médica"
"2010","Sergipe","618","2550","1348","1202","147","19","3334","Assistência Médica"
"2010","Distrito Federal","683","7751","4239","3512","170","31","8635","Assistência Médica"
"2010","Acre","24","1071","374","697","43","4","1142","Assistência Médica"
"2010","Amapá","82","590","320","270","14","4","690","Assistência Médica"
"2010","Rondônia","965","4405","1833","2572","178","40","5588","Assistência Médica"
"2010","Roraima","11","506","173","333","33","3","553","Assistência Médica"
"2010","Tocantins","117","1755","643","1112","64","18","1954","Assistência Médica"
"2011","Alagoas","467","9328","5110","4218","340","33","10168","Assistência Médica"
"2011","Amazonas","987","8790","5400","3390","164","41","9982","Assistência Médica"
"2011","Bahia","3858","20286","7739","12547","1401","131","25676","Assistência Médica"
"2011","Ceará","1168","11148","4895","6253","387","52","12755","Assistência Médica"
"2011","Mato Grosso do Sul","1541","9205","4044","5161","252","65","11063","Assistência Médica"
"2011","Espírito Santo","2779","11073","6687","4386","272","99","14223","Assistência Médica"
"2011","Goiás","1891","13795","7348","6447","251","126","16063","Assistência Médica"
"2011","Maranhão","877","5504","2222","3282","228","59","6668","Assistência Médica"
"2011","Mato Grosso","1772","11776","5187","6589","249","130","13927","Assistência Médica"
"2011","Minas Gerais","12681","65116","32005","33111","1706","348","79851","Assistência Médica"
"2011","Pará","2129","9421","4810","4611","296","74","11920","Assistência Médica"
"2011","Paraíba","469","4778","1800","2978","188","23","5458","Assistência Médica"
"2011","Paraná","7748","43036","23876","19160","1230","227","52241","Assistência Médica"
"2011","Pernambuco","2613","18333","8356","9977","391","72","21409","Assistência Médica"
"2011","Piauí","178","3385","773","2612","162","21","3746","Assistência Médica"
"2011","Rio de Janeiro","10203","39491","21510","17981","830","199","50723","Assistência Médica"
"2011","Rio Grande do Norte","1148","6308","2761","3547","192","20","7668","Assistência Médica"
"2011","Rio Grande do Sul","7675","50374","20962","29412","1300","174","59523","Assistência Médica"
"2011","Santa Catarina","4035","42516","14804","27712","1752","170","48473","Assistência Médica"
"2011","São Paulo","34760","216448","122907","93541","4485","730","256423","Assistência Médica"
"2011","Sergipe","647","2940","1598","1342","112","21","3720","Assistência Médica"
"2011","Distrito Federal","609","7831","4471","3360","176","32","8648","Assistência Médica"
"2011","Acre","46","1117","361","756","38","8","1209","Assistência Médica"
"2011","Amapá","148","687","382","305","16","10","861","Assistência Médica"
"2011","Rondônia","1542","4464","2039","2425","158","48","6212","Assistência Médica"
"2011","Roraima","21","605","257","348","25","2","653","Assistência Médica"
"2011","Tocantins","157","1705","653","1052","57","23","1942","Assistência Médica"
"2012","Alagoas","533","8089","4514","3575","399","21","9042","Assistência Médica"
"2012","Amazonas","898","8309","5328","2981","102","32","9341","Assistência Médica"
"2012","Bahia","3921","19508","7947","11561","1143","105","24677","Assistência Médica"
"2012","Ceará","1079","12005","5206","6799","307","57","13448","Assistência Médica"
"2012","Mato Grosso do Sul","1924","9511","4322","5189","238","39","11712","Assistência Médica"
"2012","Espírito Santo","2916","10505","6644","3861","293","91","13805","Assistência Médica"
"2012","Goiás","1934","14191","7782","6409","216","128","16469","Assistência Médica"
"2012","Maranhão","991","4340","1912","2428","191","42","5564","Assistência Médica"
"2012","Mato Grosso","1831","11579","5323","6256","245","115","13770","Assistência Médica"
"2012","Minas Gerais","13214","64334","32461","31873","1613","370","79531","Assistência Médica"
"2012","Pará","2816","9708","4935","4773","293","89","12906","Assistência Médica"
"2012","Paraíba","379","4657","1620","3037","207","21","5264","Assistência Médica"
"2012","Paraná","7487","42460","24244","18216","1537","221","51705","Assistência Médica"
"2012","Pernambuco","2705","17853","7866","9987","411","75","21044","Assistência Médica"
"2012","Piauí","152","3793","833","2960","202","24","4171","Assistência Médica"
"2012","Rio de Janeiro","11256","41448","23318","18130","844","178","53726","Assistência Médica"
"2012","Rio Grande do Norte","992","6033","2345","3688","207","21","7253","Assistência Médica"
"2012","Rio Grande do Sul","8180","47422","20870","26552","1312","166","57080","Assistência Médica"
"2012","Santa Catarina","5045","39868","14209","25659","1701","155","46769","Assistência Médica"
"2012","São Paulo","37170","211001","126058","84943","5019","680","253870","Assistência Médica"
"2012","Sergipe","736","2645","1450","1195","129","21","3531","Assistência Médica"
"2012","Distrito Federal","745","7950","4463","3487","164","36","8895","Assistência Médica"
"2012","Acre","65","1054","326","728","50","10","1179","Assistência Médica"
"2012","Amapá","189","764","427","337","14","7","974","Assistência Médica"
"2012","Rondônia","1691","4447","2153","2294","144","42","6324","Assistência Médica"
"2012","Roraima","47","560","241","319","7","4","618","Assistência Médica"
"2012","Tocantins","189","1500","674","826","59","18","1766","Assistência Médica"
"2013","Alagoas","471","6118","3309","2809","338","30","6957","Assistência Médica"
"2013","Amazonas","957","7807","4892","2915","123","30","8917","Assistência Médica"
"2013","Bahia","3290","18637","7802","10835","898","112","22937","Assistência Médica"
"2013","Ceará","988","12588","5803","6785","316","71","13963","Assistência Médica"
"2013","Mato Grosso do Sul","1960","9561","4490","5071","261","50","11832","Assistência Médica"
"2013","Espírito Santo","2870","10936","6958","3978","297","102","14205","Assistência Médica"
"2013","Goiás","2330","14996","8352","6644","226","104","17656","Assistência Médica"
"2013","Maranhão","738","4409","2065","2344","225","60","5432","Assistência Médica"
"2013","Mato Grosso","1920","12129","6098","6031","271","113","14433","Assistência Médica"
"2013","Minas Gerais","12958","64722","33582","31140","1689","339","79708","Assistência Médica"
"2013","Pará","2703","9666","5036","4630","283","70","12722","Assistência Médica"
"2013","Paraíba","371","4713","1885","2828","239","20","5343","Assistência Médica"
"2013","Paraná","7472","45062","26252","18810","1490","273","54297","Assistência Médica"
"2013","Pernambuco","2665","18316","8564","9752","493","76","21550","Assistência Médica"
"2013","Piauí","124","4260","1135","3125","202","27","4613","Assistência Médica"
"2013","Rio de Janeiro","11197","40772","24643","16129","850","174","52993","Assistência Médica"
"2013","Rio Grande do Norte","890","5985","2574","3411","245","27","7147","Assistência Médica"
"2013","Rio Grande do Sul","9277","50918","22726","28192","1228","141","61564","Assistência Médica"
"2013","Santa Catarina","6109","40480","15241","25239","1863","138","48590","Assistência Médica"
"2013","São Paulo","36973","215317","134081","81236","4884","733","257907","Assistência Médica"
"2013","Sergipe","694","2615","1494","1121","107","30","3446","Assistência Médica"
"2013","Distrito Federal","605","8423","4667","3756","236","30","9294","Assistência Médica"
"2013","Acre","87","1064","328","736","62","9","1222","Assistência Médica"
"2013","Amapá","153","902","447","455","10","10","1075","Assistência Médica"
"2013","Rondônia","1637","4677","2083","2594","134","38","6486","Assistência Médica"
"2013","Roraima","52","690","327","363","11","1","754","Assistência Médica"
"2013","Tocantins","104","1379","704","675","49","33","1565","Assistência Médica"
"2014","Alagoas","590","5329","2956","2373","240","35","6194","Assistência Médica"
"2014","Amazonas","1004","7923","5024","2899","119","34","9080","Assistência Médica"
"2014","Bahia","3160","18609","8074","10535","772","115","22656","Assistência Médica"
"2014","Ceará","1152","12265","5994","6271","289","60","13766","Assistência Médica"
"2014","Mato Grosso do Sul","1684","9294","4511","4783","248","64","11290","Assistência Médica"
"2014","Espírito Santo","2902","11966","8004","3962","284","100","15252","Assistência Médica"
"2014","Goiás","2413","14909","8560","6349","224","128","17674","Assistência Médica"
"2014","Maranhão","817","4732","2110","2622","246","38","5833","Assistência Médica"
"2014","Mato Grosso","1858","12080","6726","5354","229","130","14297","Assistência Médica"
"2014","Minas Gerais","11966","62147","33237","28910","1578","343","76034","Assistência Médica"
"2014","Pará","2941","10040","5327","4713","265","67","13313","Assistência Médica"
"2014","Paraíba","346","5082","2055","3027","213","20","5661","Assistência Médica"
"2014","Paraná","7344","45625","27159","18466","1287","231","54487","Assistência Médica"
"2014","Pernambuco","2474","18225","9011","9214","520","71","21290","Assistência Médica"
"2014","Piauí","140","4276","1137","3139","200","22","4638","Assistência Médica"
"2014","Rio de Janeiro","10930","41657","26126","15531","941","176","53704","Assistência Médica"
"2014","Rio Grande do Norte","994","6155","2812","3343","209","33","7391","Assistência Médica"
"2014","Rio Grande do Sul","10375","49923","24286","25637","1098","160","61556","Assistência Médica"
"2014","Santa Catarina","6560","39334","16425","22909","1858","163","47915","Assistência Médica"
"2014","São Paulo","35745","206488","133443","73045","4517","696","247446","Assistência Médica"
"2014","Sergipe","642","2576","1503","1073","111","19","3348","Assistência Médica"
"2014","Distrito Federal","739","8056","4866","3190","279","38","9112","Assistência Médica"
"2014","Acre","68","1097","313","784","83","6","1254","Assistência Médica"
"2014","Amapá","70","728","323","405","16","4","818","Assistência Médica"
"2014","Rondônia","909","4722","2211","2511","113","40","5784","Assistência Médica"
"2014","Roraima","116","714","403","311","6","8","844","Assistência Médica"
"2014","Tocantins","108","1433","762","671","50","18","1609","Assistência Médica"
"2015","Alagoas","555","4441","2979","1462","182","28","5206","Assistência Médica"
"2015","Amazonas","965","7518","4755","2763","187","31","8701","Assistência Médica"
"2015","Bahia","2870","15365","8126","7239","523","93","18851","Assistência Médica"
"2015","Ceará","1181","10700","6817","3883","235","52","12168","Assistência Médica"
"2015","Mato Grosso do Sul","1739","8201","5027","3174","246","44","10230","Assistência Médica"
"2015","Espírito Santo","2932","10444","8155","2289","196","82","13654","Assistência Médica"
"2015","Goiás","2423","13296","9380","3916","236","102","16057","Assistência Médica"
"2015","Maranhão","679","4073","2296","1777","184","40","4976","Assistência Médica"
"2015","Mato Grosso","1742","10738","7282","3456","225","104","12809","Assistência Médica"
"2015","Minas Gerais","10901","52313","33296","19017","1189","308","64711","Assistência Médica"
"2015","Pará","2441","8940","5822","3118","235","84","11700","Assistência Médica"
"2015","Paraíba","286","3993","2119","1874","179","25","4483","Assistência Médica"
"2015","Paraná","7082","40863","28977","11886","923","212","49080","Assistência Médica"
"2015","Pernambuco","2227","14764","8865","5899","526","58","17575","Assistência Médica"
"2015","Piauí","161","3779","1203","2576","158","23","4121","Assistência Médica"
"2015","Rio de Janeiro","9884","37886","27954","9932","748","160","48678","Assistência Médica"
"2015","Rio Grande do Norte","1109","5818","3297","2521","179","19","7125","Assistência Médica"
"2015","Rio Grande do Sul","9722","42794","25650","17144","958","147","53621","Assistência Médica"
"2015","Santa Catarina","5643","33044","17221","15823","1478","149","40314","Assistência Médica"
"2015","São Paulo","33898","177163","132943","44220","3946","681","215688","Assistência Médica"
"2015","Sergipe","517","2300","1516","784","79","14","2910","Assistência Médica"
"2015","Distrito Federal","777","6725","4888","1837","183","28","7713","Assistência Médica"
"2015","Acre","69","928","414","514","53","1","1051","Assistência Médica"
"2015","Amapá","84","528","297","231","17","7","636","Assistência Médica"
"2015","Rondônia","693","4134","2085","2049","106","30","4963","Assistência Médica"
"2015","Roraima","54","554","332","222","9","4","621","Assistência Médica"
"2015","Tocantins","148","1265","883","382","38","20","1471","Assistência Médica"
"2016","Alagoas","526","4029","2361","1668","190","19","4764","Assistência Médica"
"2016","Amazonas","693","6570","3809","2761","253","22","7538","Assistência Médica"
"2016","Bahia","2724","14395","7041","7354","724","82","17925","Assistência Médica"
"2016","Ceará","1302","10642","6543","4099","252","60","12256","Assistência Médica"
"2016","Mato Grosso do Sul","1865","7811","4536","3275","246","35","9957","Assistência Médica"
"2016","Espírito Santo","2549","9325","6773","2552","207","59","12140","Assistência Médica"
"2016","Goiás","2496","12948","8276","4672","257","114","15815","Assistência Médica"
"2016","Maranhão","538","3930","1923","2007","186","34","4688","Assistência Médica"
"2016","Mato Grosso","1772","10221","6252","3969","191","112","12296","Assistência Médica"
"2016","Minas Gerais","10896","48465","28353","20112","1432","286","61079","Assistência Médica"
"2016","Pará","1961","7759","4610","3149","206","60","9986","Assistência Médica"
"2016","Paraíba","273","3890","1933","1957","162","19","4344","Assistência Médica"
"2016","Paraná","6670","36983","24323","12660","990","195","44838","Assistência Médica"
"2016","Pernambuco","2038","13922","7794","6128","596","54","16610","Assistência Médica"
"2016","Piauí","164","3750","1005","2745","192","13","4119","Assistência Médica"
"2016","Rio de Janeiro","8937","33603","23412","10191","871","156","43567","Assistência Médica"
"2016","Rio Grande do Norte","800","4821","2556","2265","186","29","5836","Assistência Médica"
"2016","Rio Grande do Sul","9431","41346","22948","18398","1018","146","51941","Assistência Médica"
"2016","Santa Catarina","5398","31582","14865","16717","1812","170","38962","Assistência Médica"
"2016","São Paulo","33298","167411","117123","50288","4498","545","205752","Assistência Médica"
"2016","Sergipe","585","2135","1323","812","78","8","2806","Assistência Médica"
"2016","Distrito Federal","638","6902","4437","2465","220","21","7781","Assistência Médica"
"2016","Acre","58","900","339","561","45","2","1005","Assistência Médica"
"2016","Amapá","80","578","273","305","7","4","669","Assistência Médica"
"2016","Rondônia","499","4106","1908","2198","109","26","4740","Assistência Médica"
"2016","Roraima","60","700","378","322","16","1","777","Assistência Médica"
"2016","Tocantins","194","1330","869","461","37","16","1577","Assistência Médica"
"2017","Alagoas","616","3480","2156","1324","118","12","4226","Assistência Médica"
"2017","Amazonas","747","5981","3656","2325","276","19","7023","Assistência Médica"
"2017","Bahia","2620","13880","7275","6605","671","99","17270","Assistência Médica"
"2017","Ceará","1428","9685","6409","3276","221","60","11394","Assistência Médica"
"2017","Mato Grosso do Sul","2216","7562","5008","2554","241","40","10059","Assistência Médica"
"2017","Espírito Santo","2858","8763","6912","1851","149","55","11825","Assistência Médica"
"2017","Goiás","2823","12615","8794","3821","228","84","15750","Assistência Médica"
"2017","Maranhão","544","3316","1976","1340","183","39","4082","Assistência Médica"
"2017","Mato Grosso","2778","9455","6689","2766","174","88","12495","Assistência Médica"
"2017","Minas Gerais","11317","45490","29732","15758","1280","262","58349","Assistência Médica"
"2017","Pará","2013","7412","4914","2498","238","71","9734","Assistência Médica"
"2017","Paraíba","291","3743","2073","1670","174","16","4224","Assistência Médica"
"2017","Paraná","7078","35303","25299","10004","826","222","43429","Assistência Médica"
"2017","Pernambuco","1981","12612","7225","5387","518","48","15159","Assistência Médica"
"2017","Piauí","141","3066","1009","2057","214","15","3436","Assistência Médica"
"2017","Rio de Janeiro","8617","29589","22035","7554","815","132","39153","Assistência Médica"
"2017","Rio Grande do Norte","881","4030","2479","1551","158","21","5090","Assistência Médica"
"2017","Rio Grande do Sul","10128","37380","22763","14617","987","118","48613","Assistência Médica"
"2017","Santa Catarina","5934","30730","16501","14229","1683","123","38470","Assistência Médica"
"2017","São Paulo","34125","156676","120666","36010","2959","473","194233","Assistência Médica"
"2017","Sergipe","573","1960","1344","616","120","10","2663","Assistência Médica"
"2017","Distrito Federal","724","6338","4268","2070","182","14","7258","Assistência Médica"
"2017","Acre","87","873","390","483","52","6","1018","Assistência Médica"
"2017","Amapá","58","458","266","192","4","4","524","Assistência Médica"
"2017","Rondônia","630","3497","1974","1523","119","33","4279","Assistência Médica"
"2017","Roraima","78","799","419","380","12","5","894","Assistência Médica"
"2017","Tocantins","229","1214","893","321","49","27","1519","Assistência Médica"
"-","-","-"
